############################################################
#             #               ##########                   #
#             #    ####       #                            #
#             #       #                #                   #
#             ##########################                   #
#                 #                                        #
#                 #                                        #
#                 #                          #             #
#                 #                          #             #
#                 #                      #####             #
#                                        #                 #
#                                        #                 #
#                                        #                 #
#                                        #                 #
############################################################